D3D5513D13
BC5556C56A
83FB93FFFA
AAFC6857FA
AEFFFAFFFA
8513FAFD52
ABAAFAFFFA
AAAE94157A
AAC3A9693A
C47C6C56C6

0,0
9,7
ESEEEENESEENESSSSSSS
